map 1

s --  1 --  2 --  3
|     |           |
4 --  5 --  6 --  7
|     |     |      
8     9     10 -- 11
|     |           |
12 -- 13    e -- 15

map 2

0 --  1 --  2 --  3
|     |     |     |
4     s     6     7
|                 |
8 --  9 --  e    11
|     |     |     |
12 -- 13 -- 14 -- 15